1984	George Orwell
!!!The!!Teddy!Crazy!!Show!!!	Harlan Ellison
(Learning About) Machine Sex	Candas Jane Dorsey
...the World, as we Know 't	Howard Waldrop
2001: A Space Odyssey	Arthur C. Clarke
2004, or Thereabouts	David R. Bunch
20th Century Boys vol.1	Naoki Urasawa
20th Century Boys vol.2	Naoki Urasawa
20th Century Boys vol.3	Naoki Urasawa
20th Century Boys vol.4	Naoki Urasawa
20th Century Boys vol.5	Naoki Urasawa
20th Century Boys vol.6	Naoki Urasawa
A Biography of Tadeo Isidoro Cruz (1829-1874)	Jorge Luis Borges
A Brief History of the Trans-Pacific Tunnel	Ken Liu
A Canticle for Leibowitz	Walter M. Miller, Jr.
A Case of Conscience	James Blish
A Case of Identity	Arthur Conan Doyle
A Clash of Cymbals	James Blish
A Clockwork Orange	Anthony Burgess
A Day at Harmenz	Tadeusz Borowski
A Deskful of Girls	Fritz Leiber
A Dialog About A Dialog	Jorge Luis Borges
A Dialog Between Dead Men	Jorge Luis Borges
A Farewell to Arms	Ernest Hemingway
A Feast of Demons	William Morrison
A Few Things I Know About While Away	Joanna Russ
A Hundred Ghosts Parade Tonight	Xia Jia
A is for Automation	Kate Wilhelm
A Life for the Stars	James Blish
A Midwinter's Tale	Michael Swanwick
A Momentary Taste of Being	James Tiptree, Jr.
A Mouse in the Walls of the Global Village	Dean R. Koontz
A New Refutation of Time	Jorge Luis Borges
A Note on (toward) Bernard Shaw	Jorge Luis Borges
A Path Through the Darkness	Harlan Ellison
A Prayer for No One's Enemies	Harlan Ellison
A Problem	Jorge Luis Borges
A Scandal in Bohemia	Arthur Conan Doyle
A Scanner Darkly	Philip K. Dick
A Time of Changes	Robert Silverberg
A Tour of C++ 2nd	Bjarne Stroustrup
A Toy for Juliette	Robert Bloch
A True Story	Tadeusz Borowski
A Visit	Tadeusz Borowski
A Way of Thinking	Theodore Sturgeon
Absalom, Absalom!	William Faulkner
Adrift Just Off the Islets of Langerhans: Latitude 38o54'N, Longitude 77o00'13W	Harlan Ellison
Adrift on the Policy Level	Chandler Davis
Aesop	Clifford D. Simak
After the Days of Dead-Eye 'Dee	Pat Cadigan
Again, Dangerous Visions	Harlan Ellison
Akira vol.1	Katsuhiro Otomo
Akira vol.2	Katsuhiro Otomo
Akira vol.3	Katsuhiro Otomo
Akira vol.4	Katsuhiro Otomo
Akira vol.5	Katsuhiro Otomo
Akira vol.6	Katsuhiro Otomo
Algorithms 4th	Kevin Wayne
Algorithms 4th	Robert Sedgewick
All in Good Time	Miram Allen deFord
All the Birds Come Home to Roost	Harlan Ellison
All the Flavors	Ken Liu
All the Lies Lies That Are My Life	Harlan Ellison
All The People	R. A. Lafferty
All the Sound of Fear	Harlan Ellison
All Tomorrow's Parties	William Gibson
Along the Scenic Route	Harlan Ellison
Alpha Ralpha Boulevard	Cordwainer Smith
Amateur in Chancery	George O. Smith
America	Orson Scott Card
An Advanced Readers' Picture Book of Comparative Cognition	Ken Liu
An Examination of the Work of Herbert Quain	Jorge Luis Borges
And Chaos Died	Joanna Russ
And the Angels Sing	Kate Wilhelm
And the Moon be Still as Bright	Ray Bradbury
And the Sea Like Mirrors	Gregory Benford
Andover and the Android	Kate Wilhelm
Angry Candy	Harlan Ellison
Animal Farm	George Orwell
Anybody Else Like Me?	Walter M. Miller, Jr.
Anywhere But Here, With Anybody But You	Harlan Ellison
Approaching Oblivion	Harlan Ellison
April Fools' Day Forever	Kate Wilhelm
Argumentum Ornithologicum	Jorge Luis Borges
Army of None	Paul Scharre
As Simple As That	Zenna Henderson
At the End of the Orbit	Arthur C. Clarke
At the Mouse Circus	Harlan Ellison
Aunt Parnetta's Electric Blisters	Diane Glancy
Auschwitz, Our Home (A Letter)	Tadeusz Borowski
Auto-De-Fe	Roger Zelazny
Avatars of the Tortoise	Jorge Luis Borges
Averroes' Search	Jorge Luis Borges
Aye, and Gomorrah...	Samuel R. Delany
Balanced Ecology	James H. Schmitz
Basilisk	Harlan Ellison
Battle for the Mind	William Sargant
Battle Without Banners	Harlan Ellison
Battlefield	Harlan Ellison
Beachhead	Clifford D. Simak
Beauty's Beast	Robert Bloch
Bed Sheets are White	Evelyn Lief
Beowulf	Anonymous
Bettyann	Kris Neville
Beyond the Blue Event Horizon	Frederik Pohl
Bianca's Hands	Theodore Sturgeon
Bible and Sword	Barbara W. Tuchman
Big Joe and the Nth Generation	Walter M. Miller, Jr.
Blabbermouth	Theodore Sturgeon
Black Bargain	Robert Bloch
Blame! vol.1	Tsumotu Nihei
Blame! vol.2	Tsumotu Nihei
Blame! vol.3	Tsumotu Nihei
Blame! vol.4	Tsumotu Nihei
Blame! vol.5	Tsumotu Nihei
Blame! vol.6	Tsumotu Nihei
Blank?	Harlan Ellison
Bleeding Stones	Harlan Ellison
Blind Bird, Blind Bird, Go Away From Me!	Harlan Ellison
Blood Bank	Walter M. Miller, Jr.
Blot	Gahan Wilson
Blowups Happen	Robert A. Heilein
Blue Spring	Taiyo Matsumoto
Borges and I	Jorge Luis Borges
Bounty	T. L. Sherred
Brain Wave	Poul Anderson
Brass and Gold (or Horse and Zeppelin in Beverly Hills)	Philip Jose Farmer
Brave New World	Aldous Huxley
Bright Eyes	Harlan Ellison
Bright Segment	Theodore Sturgeon
Broken Glass	Harlan Ellison
Brownshoes	Theodore Sturgeon
Burning Chrome	William Gibson
By His Bootstraps	Robert A. Heinlein
C Primer Plus 5th	Stephen Prata
C++ Primer 5th	Barbara E. Moo
C++ Primer 5th	Josee Lajoie
C++ Primer 5th	Stanley B. Lippman
Call Girl	Tang Fei
Camps	Jack Dann
Capitalism Without Capital	Jonathan Haskel
Capitalism Without Capital	Stian Westlake
Captain Harlock: The Classic Collection vol.1	Leiji Matsumoto
Captain Harlock: The Classic Collection vol.2	Leiji Matsumoto
Captain Harlock: The Classic Collection vol.3	Leiji Matusmoto
Carcinoma Angels	Norman Spinard
Catch That Rabbit	Isaac Asimov
Catch-22	Joseph Heller
Catman	Harlan Ellison
Caviar	Theodore Sturgeon
Census	Clifford D. Simak
Chain Reaction	Boyd Ellanby
Chained to the Fast Lane in the Red Queen's Race	Harlan Ellison
Changewar	Fritz Leiber
Chapterhouse: Dune	Frank Herbert
Chatting with Anubis	Harlan Ellison
Childhood's End	Arthur C. Clarke
Children of Dune	Frank Herbert
Children of the Sea vol.1	Daisuke Igarashi
Children of the Sea vol.2	Daisuke Igarashi
Children of the Sea vol.3	Daisuke Igarashi
Children of the Sea vol.4	Daisuke Igarashi
Children of the Sea vol.5	Daisuke Igarashi
Ching Witch!	Ross Rocklynne
Christ, Old Student in a New School	Ray Bradbury
Chuck Berry, Won't You Please Come Home	Ken McCullough
City	Clifford D. Simak
Cold Friend	Harlan Ellison
Collecting Team	Robert Silverberg
Colossus	B. Jack Copeland
Columbus Was a Dope	Robert A. Heinlein
Come to the Party	F. M. Busby
Comes Now the Power	Roger Zelazny
Commuter's Problem	Harlan Ellison
Conversations With Jorge Luis Borges	Richard Burgin
Corpse	Harlan Ellison
Count the Clock That Tells the Time	Harlan Ellison
Count Zero	William Gibson
Covered Mirrors	Jorge Luis Borges
Crate	Theodore Sturgeon
Crazy as a Soup Sandwich	Harlan Ellison
Croatoan	Harlan Ellison
Crome Yellow	Aldous Huxley
Crucifixus Etiam	Walter M. Miller, Jr.
Curse 5.0	Liu Cixin
Damnation Morning	Fritz Leiber
Dandelion Wine	Ray Bradbury
Dangerous Visions	Harlan Ellison
Danger-Human!	Gordon R. Dickson
Daniel White for the Greater Good	Harlan Ellison
Darkness Upon the Face of the Deep	Harlan Ellison
Day Million	Frederik Pohl
Deal From the Bottom	Harlan Ellison
Death and the Compass	Jorge Luis Borges
Death and the Penguin	Andrey Kurkov
Deathbird Stories	Harlan Ellison
Death's End	Liu Cixin
Deeper than the Darkness	Harlan Ellison
Delia Elena San Marco	Jorge Luis Borges
Delusion for a Dragon Slayer	Harlan Ellison
Design Patterns	Erich Gamma
Design Patterns	John Vlissides
Design Patterns	Ralph Johnson
Design Patterns	Richard Helm
Destined for War	Graham Allison
Deutsches Requiem	Jorge Luis Borges
Devourer	Liu Cixin
Dirk Gently's Holistic Detective Agency	Douglas Adams
Distant Signals	Andrew Weiner
Distrust That Particular Flavor	William Gibson
Division by Zero	Ted Chiang
Django	Harlan Ellison
Djinn, No Chaser	Harlan Ellison
Do Androids Dream of Electric Sheep?	Philip K. Dick
Doctor Zhivago	Boris Pasternak
Dogfight	Michael Swanwick
Dogfight	William Gibson
Do-It-Yourself	Harlan Ellison
Don Quixote	Miguel de Cervantes Saavedra
Double Star	Robert A. Heinlein
Downward to the Earth	Robert Silverberg
Dr. Bloodmoney	Philip K. Dick
Dreamtigers	Jorge Luis Borges
Dumb Waiter	Walter M. Miller, Jr.
Dune	Frank Herbert
Dune Messiah	Frank Herbert
Dying Inside	Robert Silverberg
Each an Explorer	Isaac Asimov
Earthman, Come Home	James Blish
Earthman, Go Home!	Harlan Ellison
Ecowarewness	Harlan Ellison
Eidolons	Harlan Ellison
Elbow Room	Marion Zimmer Bradley
Elegy	Jorge Luis Borges
Elouise and the Doctors of the Planet Pergamon	Josephine Saxton
Emanon vol.1: Memories of Emanon	Kenji Tsuruta
Emanon vol.2: Emanon Wanderer pt.1	Kenji Tsuruta
Emanon vol.3: Emanon Wanderer pt.2	Kenji Tsuruta
Emissary from Hamelin	Harlan Ellison
Emma Zunz	Jorge Luis Borges
Empire of the Sun	Andrew Weiner
Empire Star	Samuel R. Delany
Encounter With A Hick	Jonathan Brand
Ender's Game	Orson Scott Card
Endless Frontier	G. Pascal Zachary
Endymion	Dan Simmons
Enemy Mine	Barry B. Longyear
Eniac	Scott McCartney
Epilogue	Clifford D. Simak
Epiphany for Aliens	David Kerr
Ernest and the Machine God	Harlan Ellison
Erotophobia	Harlan Ellison
Ersatz	Henry Slesar
Escape!	Isaac Asimov
Escapegoat	Harlan Ellison
Eutopia	Poul Anderson
Evensong	Lester del Rey
Everything and Nothing	Jorge Luis Borges
Evidence	Isaac Asimov
Exploration Team	Murray Leinster
Explorers of Space	Robert Silverberg
Exposures	Gregory Benford
Eye of the Beholder	Burt K. Filer
Fahrenheit 451	Ray Bradbury
Faith of our Fathers	Philip K. Dick
Fault-Tolerant Computer System Designs	Dhiraj K. Pradhan
Fear is a Cold Black	Kate Wilhelm
Feather Tigers	Gene Wolfe
Featherbed on Chlyntha	Miram Allen deFord
Fiasco	Stanislaw Lem
Ficciones	Jorge Luis Borges
Final Trophy	Harlan Ellison
Flies	Robert Silverberg
Flop Sweat	Harlan Ellison
Flow My Tears, the Policeman Said	Philip K. Dick
Flowers for Algernon	Daniel Keyes
Folding Beijing	Hao Jingfang
Footsteps	Harlan Ellison
For the Sake of Grace	Suzette Haden Elgin
For Value Received	Andrew J. Ouffutt
For Whom the Bell Tolls	Ernest Hemingway
Forward the Foundation	Isaac Asimov
Foundation	Isaac Asimov
Foundation and Earth	Isaac Asimov
Foundation and Empire	Isaac Asimov
Foundation's Edge	Isaac Asimov
Fragments of a Hologram Rose	William Gibson
Frank Herbert	Nebula Winners Fifteen
Frederik Pohl	The Expert Dreamers
From A to Z, In The Chocolate Alphabet	Harlan Ellison
From the Government Printing Office	Kris Neville
Frozen Journey	Philip K. Dick
Funes the Memorious	Jorge Luis Borges
G. B. K.-A Many-Flavored Bird	Harlan Ellison
Gateway	Frederik Pohl
Gather Blue Roses	Pamela Sargent
Gathi	Miram Allen deFord
Getting Along	James Blish
Ghost in the Shell	Shirow Masamune
Ghost in the Shell vol.1.5: Human-Error Processor	Shirow Masamune
Ghost in the Shell vol.2: Man-Machine Interface	Shirow Masamune
Ghost of a Chance	Theodore Sturgeon
giANTS	Edward Bryant
Gift from the Stars	Kate Wilhelm
Giganto Maxia	Kentaro Miura
Gnomebody	Harlan Ellison
Go Toward the Light	Harlan Ellison
Go, Go, Go, Said the Bird	Sonya Dorman
God Emperor of Dune	Frank Herbert
Goldfish Bowl	Robert A. Heinlein
Gonna Roll the Bones	Fritz Leiber
Good Hunting	Ken Liu
Good News from the Vatican	Robert Silverberg
Gopher in the Gilly	Harlan Ellison
Grail	Harlan Ellison
Grave of the Fireflies	Cheng Jingbo
Gutter Gang	Harlan Ellison
Hadj	Harlan Ellison
Half-Life	Paul Preuss
Hamlet	William Shakespeare
Harry the Hare	James B. Hemesath
Hawksbill Station	Robert Silverberg
Heart of Darkness	Joseph Conrad
Heavyplanet	Lee Gregor
Heechee Rendezvous	Frederik Pohl
Heechee Treasures	Frederik Pohl
Hell Is the Absence of God	Ted Chiang
Heretics of Dune	Frank Herbert
High Weir	Samuel R. Delany
Hindsight: 480 Seconds	Harlan Ellison
Hinterlands	William Gibson
His Vegetable	Pat Murphy
Hitler Painted Roses	Harlan Ellison
Hobbies	Clifford D. Simak
Homecoming	Ray Bradbury
Homelanding	Margaret Atwood
Houston, Houston, Do You Read?	James Tiptree, Jr.
How Beautiful with Banners	James Blish
How's the Night Life on Cassalda?	Harlan Ellison
Huddling Place	Clifford D. Simak
Humpty Dumpty had a Great Fall	Frank Belknap
Hyperion	Dan Simmons
I Curse the Lesson and Bless the Knowledge	Harlan Ellison
I Will Fear No Evil	Robert A. Heinlein
I, Dreamer	Walter M. Miller, Jr.
I, Robot	Isaac Asimov
Ibn-Hakam al-Bokhari, Murdered in His Labyrinth	Jorge Luis Borges
Ichi-F	Kazuto Tatsuta
Idoru	William Gibson
If All Men Were Brothers, Would You Let One Marry Your Sister?	Theodore Sturgeon
I'm Looking for Kadak	Harlan Ellison
In Fear of K	Harlan Ellison
In Lonely Islands	Harlan Ellison
In Memoriam, J. F. K.	Jorge Luis Borges
In re Glover	Leonard Tushnet
In the Barn	Piers Anthony
In the Core	Frederik Pohl
In the Fourth Year of the War	Harlan Ellison
Incident in Moderan	David R. Bunch
Inferno, I, 32	Jorge Luis Borges
Inferno: The World at War, 1939-1945	Max Hastings
Interim	Ray Bradbury
Interlocking Pieces	Molly Gloss
Into the Wild	Jon Krakauer
Into Thin Air	Jon Krakauer
Invaders	John Kessel
Invasion Footnote	Harlan Ellison
Invisible Man	Ralph Ellison
Invisible Planets	Hao Jingfang
It	Theodore Sturgeon
It was Nothing-Really	Theodore Sturgeon
It's You!	Theodore Sturgeon
J. C. on the Dude Ranch	Philip Jose Farmer
Jack-in-the-Box	Ray Bradbury
Jane Doe #112	Harlan Ellison
Jeffty is Five	Harlan Ellison
Jenny with Wings	Kate Wilhelm
Johnny Mnemonic	William Gibson
Jorry's Gap	Theodore Sturgeon
Judas	John Brunner
Julius Caesar	William Shakespeare
Jupiter Five	Arthur C. Clarke
Jurassic Park	Michael Crichton
Kafka and His Precursors	Jorge Luis Borges
Invisible Planets	Ken Liu
Keyboard	Harlan Ellison
Killdozer!	Theodore Sturgeon
Killing Bernstein	Harlan Ellison
King of the Hill	Chad Oliver
Kirinyaga	Mike Resnick
Kiss of Fire	Harlan Ellison
Knights to Move	Fritz Leiber
Knox	Harlan Ellison
Kyrie	Poul Anderson
Labyrinths	Jorge Luis Borges
Ladies and Gentlemen, This Is Your Crisis	Kate Wilhelm
Lamia Mutable	M. John Harrison
Land of the Great Horses	R. A. Lafferty
Last Train to Kankakee	Robin Scott
Laugh Track	Harlan Ellison
Leadership in Turbulent Times	Doris Kearns Goodwin
Lenny	Isaac Asimov
Let There Be Light	Robert A. Heilein
Liar!	Isaac Asimov
Life in Our Time	Robert Bloch
Life, the Universe and Everything	Douglas Adams
Life-Line	Robert A. Heilein
Liking What You See: A Documentary	Ted Chiang
Little Lost Robot	Isaac Asimov
Lollipop and the Tar Baby	John Varley
Lonley Women Are the Vessels of Time	Harlan Ellison
Looking for Company	Frederik Pohl
Lord of Light	Roger Zelazny
Lord of the Flies	William Golding
Lord Randy, My Son	Joe L. Hensley
Love Ain't Nothing but Sex Misspelled	Harlan Ellison
Lucy Comes To Stay	Robert Bloch
Madame Curie	Eve Curie
Making It All the Way into the Future on Gaxton Falls of the Red Planet	Barry N. Malzberg
Man of Letters	Kate Wilhelm
Man Plus	Frederik Pohl
Martin Fierro	Jorge Luis Borges
Martin the Warrior	Brian Jacques
Master and Commander	Patrick O'Brian
Mathoms from the Time Closet	Gene Wolfe
Mattimeo	Brian Jacques
Mealtime	Harlan Ellison
Medusa	Theodore Sturgeon
Mefisto in Onyx	Harlan Ellison
Microcosmic God	Theodore Sturgeon
Midnight in the Sunken Cathedral	Harlan Ellison
Midnight News	Lisa Goldstein
Mom	Harlan Ellison
Mona at Her Windows	Harlan Ellison
Mona Lisa Overdrive	William Gibson
Monitored Dreams & Strategic Cremations	Bernard Wolfe
Mono no Aware	Ken Liu
Monolog	Philip Jose Farmer
Monster vol.1	Naoki Urasawa
Monster vol.2	Naoki Urasawa
Monster vol.3	Naoki Urasawa
Monster vol.4	Naoki Urasawa
Monster vol.5	Naoki Urasawa
Monster vol.6	Naoki Urasawa
Monster vol.7	Naoki Urasawa
Monster vol.8	Naoki Urasawa
Monster vol.9	Naoki Urasawa
More Than Human	Theodore Sturgeon
Moth Race	Richard Hill
Mountain	Liu Cixin
Mr. Costello, Hero	Theodore Sturgeon
Mrs. Bagley Goes to Mars	Kate Wilhelm
Mutations	Jorge Luis Borges
Nackles vr.1	Donald E. Westlake
Nackles vr.2	Donald E. Westlake
Nackles vr.2	Harlan Ellison
Nausicaa of the Valley of the Wind vol.1	Hayao Miyazaki
Nausicaa of the Valley of the Wind vol.2	Hayao Miyazaki
Neither Your Jenny Nor Mine	Harlan Ellison
Neon	Harlan Ellison
Neuromancer	William Gibson
New Rose Hotel	William Gibson
Night Journey of the Dragon-Horse	Xia Jia
Night Meeting	Ray Bradbury
Night of Black Glass	Harlan Ellison
Nightfall	Isaac Asimov
Nightfall	Robert Silverberg
Night-Rise	Katherine MacLean
Nijigagara Holograph	Inio Asano
Nine Hundred Grandmothers	R. A. Lafferty
No Game for Children	Harlan Ellison
No Great Magic	Fritz Leiber
No Light in the Windows	Kate Wilhelm
Nothing for My Noon Meal	Harlan Ellison
Nova	Samuel R. Delany
O Ye of Little Faith	Harlan Ellison
Oddy and Id	Alfred Bester
Of Ants and Dinosaurs	Liu Cixin
On Exactitude and Science	Jorge Luis Borges
On the Downhill Slide	Harlan Ellison
On the Feasibility of Coal-Driven Power Stations	O. R. Frisch
On the Slab	Harlan Ellison
One Day in the Life of Ivan Denisovich	Aleksandr Solzhenitsyn
One for the Road	Kate Wilhelm
One Life, Furnished in Early Poverty	Harlan Ellison
One-Way Journey	Miram Allen deFord
Operating Systems in Depth	Thomas W. Doeppner
Operation Cassandra	Miram Allen deFord
Opium	Harlan Ellison
Other Worlds	Frederik Pohl
Out of All Them Bright Stars	Nancy Kress
Over the River and Through the Woods	Clifford D. Simak
Overlord	Max Hastings
Ozymandias	Terry Car
Paingod	Harlan Ellison
Paingod and Other Delusions	Harlan Ellison
Paladin of the Last Hour	Harlan Ellison
Parable of Cervantes and the Quixote	Jorge Luis Borges
Parable of the Palace	Jorge Luis Borges
Paradise	Clifford D. Simak
Paradiso, XXXI, 108	Jorge Luis Borges
Partial Magic in the Quixote	Jorge Luis Borges
Pattern Recognition	William Gibson
Paulie Charmed the Sleeping Woman	Harlan Ellison
Permanent Record	Edward Snowden
Persona 3: Official Design Works	Shigenori Soejima
Persona 4 Arena: Official Design Works	Shigenori Soejima
Persona 4: Official Design Works	Shigenori Soejima
Philtre Tip	Robert Bloch
Picnic on Paradise	Joanna Russ
Pierre Menrad, Author of Don Quixote	Jorge Luis Borges
Planet Story	Kate Wilhelm
Planetes vol.1	Makoto Yukimura
Planetes vol.2	Makoto Yukimura
Player Piano	Kurt Vonnegut
Precession	Edward Bryant
Prelude to Foundation	Isaac Asimov
Presidents of War	Michael Beschloss
Pretty Maggie Moneyeyes	Harlan Ellison
Prince Myshkin, and Hold the Relish	Harlan Ellison
Prodigy	Theodore Sturgeon
Project Nightmare	Robert A. Heinlein
Pulling Hard Time	Harlan Ellison
Punky & The Yale Men	Harlan Ellison
Queen Emeraldas vol.1	Leiji Matsumoto
Queen Emeraldas vol.2	Leiji Matsumoto
Quick to Haste	Miram Allen deFord
Quicktime	Harlan Ellison
Radio Free Albemuth	Philip K. Dick
Ragnarok	Jorge Luis Borges
Rain, Rain, Go Away	Harlan Ellison
Rat	James Patrick Kelly
Reason	Isaac Asimov
Red Star, Winter Orbit	Bruce Sterling
Red Star, Winter Orbit	William Gibson
Redwall	Brian Jacques
Rendezvous with Rama	Arthur C. Clarke
Repent, Harlequin! Said the Ticktockman	Harlan Ellison
Requiem	Robert A. Heilein
Riders of the Purple Wage	Philip Jose Farmer
Riding the Dark Train Out	Harlan Ellison
Ringworld	Larry Niven
Riverworld	Philip Jose Farmer
Riverworld and Other Stories	Philip Jose Farmer
Roadside Picnic	Arkady Strugatsky
Roadside Picnic	Boris Strugatsky
Robbie	Isaac Asimov
Rock God	Harlan Ellison
Rocket Summer	Ray Bradbury
Runaround	Isaac Asimov
Sandkings	George R. R. Martin
Saturn, November 11th	Harlan Ellison
Scartaris, June 28th	Harlan Ellison
Schrodinger's Plague	Greg Bear
Schwarzschild Radius	Connie Willis
Second Foundation	Isaac Asimov
Seeing	Harlan Ellison
Selected Poems	T. S. Eliot
Selected Stories	Theodore Sturgeon
Sensible City	Harlan Ellison
Seraphim: 266613336 Wings	Satoshi Kon
Seventy-Two Letters	Ted Chiang
Sex and/or Mr. Morrison	Carol Emshwiller
Shadow, Shadow on the Wall	Theodore Sturgeon
Shall the Dust Praise Thee?	Damon Knight
Shatterday	Harlan Ellison
Shattered Like a Glass Goblin	Harlan Ellison
She's a Young Thing and Cannot Leaver Her Mother	Harlan Ellison
Shin Megami Tensei 4: Official Artworks	Masayuki Doi
Shoppe Keeper	Harlan Ellison
Silence	Tadeusz Borowski
Silent in Gehenna	Harlan Ellison
Silhouette	Gene Wolfe
Simulacrum	Ken Liu
Sir Gawain and the Green Knight	J. R. R. Tolkien
Skeleton	Ray Bradbury
Skunk Works	Ben R. Rich
Skunk Works	Leo Janos
Sky Lift	Robert A. Heinlein
Slippage	Harlan Ellison
Slow Sculpture	Theodore Sturgeon
Snow	John Crowley
So Long, and Thanks for All the Fish	Douglas Adams
Soft Monkey	Harlan Ellison
Solanin	Inio Asano
Solaris	Stanislaw Lem
Some Assembly Required	Timothy S. Margush
Somehow, I Don't Think We're in Kansas, Toto	Harlan Ellison
Somerset Dreams	Kate Wilhelm
Somerset Dreams and Other Fictions	Kate Wilhelm
Souls	Joanna Russ
Soundless Evening	Lee Hoffman
Speech Sound	Octavia E. Butler
Spook Country	William Gibson
Stable Strategies for Middle Management	Eileen Gunn
Stalingrad	Antony Beevor
Stalking the Nightmare	Harlan Ellison
Stand Still and Die	Harlan Ellison
Starship Troopers	Robert A. Heinlein
State Change	Ken Liu
State of Grace	Kate Wilhelm
Still-Life	K. M. O'Donnell
Stillwell and the American Experience in China 1911-1945	Barbara W. Tuchman
Stoned Counsel	H. H. Hollis
Stories of Your Life and Others	Ted Chiang
Story of the Warrior and the Captive Maiden	Jorge Luis Borges
Story of Your Life	Ted Chiang
Strange Gifts	Robert Silverberg
Strange Wine	Harlan Ellison
Stranger in a Strange Land	Robert A. Heinlein
Stuffing	Harlan Ellison
Sturgeon is Alive and Well...	Theodore Sturgeon
Suicide	Theodore Sturgeon
Sun of China	Liu Cixin
Symbiosis	Kate Wilhelm
Take Care of Joey	Theodore Sturgeon
Taking Care of God	Liu Cixin
Tandy's Story	Theodore Sturgeon
Tauf Aleph	Physillis Gotlieb
Team of Rivals	Doris Kearns Goodwin
Tekkonkinkreet: Black and White	Taiyo Matsumoto
Tell Your Fortune	Robert Bloch
Test to Destruction	Keith Laummer
That Girl Who Knew What They Meant	Theodore Sturgeon
The [Widget], the [Wadget], and Boff	Theodore Sturgeon
The 10:00 Report is Brought to You By...	Edward Bryant
The 3 Most Important Things in Life	Harlan Ellison
The Absolutely Perfect Murder	Miram Allen deFord
The Adventure of Black Peter	Arthur Conan Doyle
The Adventure of Charles Augustus Milverton	Arthur Conan Doyle
The Adventure of the Gloria Scott	Arthur Conan Doyle
The Adventure of the Abbey Grange	Arthur Conan Doyle
The Adventure of the Beryl Coronet	Arthur Conan Doyle
The Adventure of the Blue Carbuncle	Arthur Conan Doyle
The Adventure of the Cardboard Box	Arthur Conan Doyle
The Adventure of the Copper Beeches	Arthur Conan Doyle
The Adventure of the Crooked Man	Arthur Conan Doyle
The Adventure of the Dancing Men	Arthur Conan Doyle
The Adventure of the Empty House	Arthur Conan Doyle
The Adventure of the Engineer's Thumb	Arthur Conan Doyle
The Adventure of the Final Problem	Arthur Conan Doyle
The Adventure of the Golden Pince-Nez	Arthur Conan Doyle
The Adventure of the Greek Interpreter	Arthur Conan Doyle
The Adventure of the Missing Three-Quarter	Arthur Conan Doyle
The Adventure of the Musgrave Ritual	Arthur Conan Doyle
The Adventure of the Naval Treaty	Arthur Conan Doyle
The Adventure of the Noble Bachelor	Arthur Conan Doyle
The Adventure of the Norwood Builder	Arthur Conan Doyle
The Adventure of the Priory School	Arthur Conan Doyle
The Adventure of the Reigate Squires	Arthur Conan Doyle
The Adventure of the Resident Patient	Arthur Conan Doyle
The Adventure of the Second Stain	Arthur Conan Doyle
The Adventure of the Silver Blaze	Arthur Conan Doyle
The Adventure of the Six Napoleons	Arthur Conan Doyle
The Adventure of the Solitary Cyclist	Arthur Conan Doyle
The Adventure of the Speckled Band	Arthur Conan Doyle
The Adventure of the Stockbroker's Clerk	Arthur Conan Doyle
The Adventure of the Yellow Face	Arthur Conan Doyle
The Age of Gold	Frederik Pohl
The Ajeri Diary	Miram Allen deFord
The Aleph	Jorge Luis Borges
The Aleph and Other Stories	Jorge Luis Borges
The Annals of the Heechee	Frederik Pohl
The Approach to Al-Mu'tasim	Jorge Luis Borges
The Argentine Writer and Tradition	Jorge Luis Borges
The Art of Computer Programming vol.1	Donald E. Knuth
The Art of Nausicaa of the Valley of the Wind	Hayao Miyazaki
The Art of Persona 5	Shigenori Soejima
The Art of Space	Ron Miller
The Avenger of Death	Harlan Ellison
The Babylon Lottery	Jorge Luis Borges
The Beast of Barsac	Robert Bloch
The Belonging Kind	John Shirley
The Belonging Kind	William Gibson
The Big Hunger	Walter M. Miller, Jr.
The Big Space Fuck	Kurt Vonnegut, Jr.
The Big Time	Fritz Leiber
The Black Cloud	Fred Hoyle
The Bob Dylan Tambourine Software & Satori Support Services Consortium, Ltd.	Michael Bishop
The Book of Skulls	Robert Silverberg
The Bookmaking Habits of Select Species	Ken Liu
The Boscombe Valley Mystery	Arthur Conan Doyle
The Boulevard of Broken Dreams	Harlan Ellison
The Boy Who Would Live Forever	Frederik Pohl
The Brains of Rats	Michael Blumlein
The Byrds	Michael G. Coney
The Captive	Jorge Luis Borges
The Cat Who Walks Through Walls	Robert A. Heinlein
The Catcher in the Rye	J. D. Salinger
The Cheese Stands Alone	Harlan Ellison
The Children	Miram Allen deFord
The Chrysalids	John Wyndham
The Circle	Liu Cixin
The Circular Ruins	Jorge Luis Borges
The Cistern	Ray Bradbury
The City of Silence	Ma Boyong
The Classic Horror Stories	H. P. Lovecraft
The Crackpots	Harlan Ellison
The Crowd	Ray Bradbury
The Dark Design	Philip Jose Farmer
The Dark Forest	Liu Cixin
The Daughter of the Tree	Miram Allen deFord
The Day After the Day the Martians Came	Frederik Pohl
The Day I Died	Harlan Ellison
The Day of the Triffids	John Wyndham
The Dead Man	Jorge Luis Borges
The Death of Schillinger	Tadeusz Borowski
The Deathbird	Harlan Ellison
The Demolished Man	Alfred Bester
The Diagnosis of Dr. Darqueangel	Harlan Ellison
The Difference Engine	Bruce Sterling
The Difference Engine	William Gibson
The Discarded	Harlan Ellison
The Dispossessed	Ursula K. Le Guin
The Divine Invasion	Philip K. Dick
The Doll-House	James Cross
The Dragon on the Bookshelf	Harlan Ellison
The Dragon on the Bookshelf	Robert Silverberg
The Dreaming Jewels	Theodore Sturgeon
The Dreams a Nightmare Dreams	Harlan Ellison
The Dune Encyclopedia	Dr. Willis E. McNelly
The Dwarf	Ray Bradbury
The Earth Men	Ray Bradbury
The Electric Kool-Aid Acid Test	Tom Wolfe
The Emissary	Ray Bradbury
The Encounter	Kate Wilhelm
The End	Jorge Luis Borges
The Evitable Conflict	Isaac Asimov
The Evolution of Human Science	Ted Chiang
The Executioner of the Malformed Children	Harlan Ellison
The Extraordinary Voyages of Amelie Bertrand	Joanna Russ
The Eyes of Heisenberg	Frank Herbert
The Face of Helene Bournouw	Harlan Ellison
The Fall of Hyperion	Dan Simmons
The Fearful Sphere of Pascal	Jorge Luis Borges
The Fellowship of the Ring	J. R. R. Tolkien
The Few, the Proud	Harlan Ellison
The Fish of Lijiang	Chen Qiufan
The Five Orange Pips	Arthur Conan Doyle
The Flower of Shazui	Chen Qiufan
The Forces that Crush	Harlan Ellison
The Forever War	Joe Haldeman
The Form of the Sword	Jorge Luis Borges
The Fountains of Paradise	Arthur C. Clarke
The Function of Dream Sleep	Harlan Ellison
The Funeral	Kate Wilhelm
The Fusion Bomb	Kate Wilhelm
The Garden of Forking Paths	Jorge Luis Borges
The Gateway Asteroid	Frederik Pohl
The Gateway Trip	Frederik Pohl
The Gernsback Continum	William Gibson
The Girl From Mars	Robert Bloch
The Goddess in the Ice	Harlan Ellison
The Godmakers	Frank Herbert
The Gods Lie.	Kaori Ozaki
The God's Script	Jorge Luis Borges
The Gods Themselves	Isaac Asimov
The Golden Helix	Theodore Sturgeon
The Golden Man	Philip K. Dick
The Great Gatsby	F. Scott Fitzgerald
The Green Morning	Ray Bradbury
The Guns of August	Barbara W. Tuchman
The Handler	Damon Knight
The Happy Breed	John T. Sladek
The Heart of the Other Side	George Gamow
The Henry Miller Dawn Patrol	Philip Jose Farmer
The Hitchhiker's Guide to the Galaxy	Douglas Adams
The Hobbit	J. R. R. Tolkien
The Home Planet	Frederik Pohl
The Hounds	Kate Wilhelm
The Hour That Stretches	Harlan Ellison
The House of Asterion	Jorge Luis Borges
The House the Blakeneys Built	Avram Davidson
The Immortal	Jorge Luis Borges
The Incredible Voyage	Tristan Jones
The Indian Spirit Guide	Robert Bloch
The Infinity Box	Kate Wilhelm
The Invasion	Robert Willey
The January Offensive	Tadeusz Borowski
The Jar	Ray Bradbury
The Jigsaw Man	Larry Niven
The Jungle Rot Kid on the Nod	Philip Jose Farmer
The Korean War	Max Hastings
The Lake	Ray Bradbury
The Lake Was Full of Artificial Things	Karen Joy Fowler
The Last Days of the Captain	Kate Wilhelm
The Last Generation?	Miram Allen deFord
The Lathe of Heaven	Ursula K. Le Guin
The Leaser of Two Evils	Philip Jose Farmer
The Library of Babel	Jorge Luis Borges
The Life of Anybody	Robert Sheckley
The Lingering Scent of Woodsmoke	Harlan Ellison
The Literomancer	Ken Liu
The Litigation Master and the Monkey King	Ken Liu
The Living Demons	Robert Bloch
The Locusts	Ray Bradbury
The Long Dark Tea-Time of the Soul	Douglas Adams
The Long Space Age	Alexander MacDonald
The Long Years	Ray Bradbury
The Longest Fall	Liu Cixin
The Lost World	Michael Crichton
The Lottery in Babylon	Jorge Luis Borges
The Lucky Strike	Kim Stanley Robinson
The Luggage Store	Ray Bradbury
The Maker	Jorge Luis Borges
The Malley System	Miriam Allen deFord
The Man in the High Castle	Philip K. Dick
The Man on the Threshold	Jorge Luis Borges
The Man Upstairs	Ray Bradbury
The Man Who Ended History: A Documentary	Ken Liu
The Man Who Lost the Sea	Theodore Sturgeon
The Man Who Rowed Christopher Columbus Ashore	Harlan Ellison
The Man Who Sold the Moon	Robert A. Heinlein
The Man Who Was Heavily into Revenge	Harlan Ellison
The Man Who Went to the Moon-Twice	Howard Rodman
The Man With English	Horace L. Gold
The Man with the Package	Tadeusz Borowski
The Man With the Twisted Lips	Arthur Conan Doyle
The Man without a Planet	Kate Wilhelm
The Manhattan Project	Al Cimino
The March of Folly	Barbara W. Tuchman
The Mark Gable Foundation	Leo Szilard
The Martian	Ray Bradbury
The Martian Chronicles	Ray Bradbury
The Menace from Earth	Robert A. Heinlein
The Merchants of Venus	Frederik Pohl
The Micro-Age	Liu Cixin
The Mile-Long Spaceship	Kate Wilhelm
The Milk of Paradise	James Tiptree, Jr.
The Million-Year Picnic	Ray Bradbury
The Miracle of the Broom Closet	W. Norbert
The Mirrors of Enigmas	Jorge Luis Borges
The Moon is a Harsh Mistress	Robert A. Heinlein
The Mountains of Sunset, the Mountains of Dawn	Vonda N. McIntyre
The Mountebank	Jorge Luis Borges
The Museum on Cyclops Avenue	Harlan Ellison
The Musicians	Ray Bradbury
The Naming of Names	Ray Bradbury
The New Atlantis	Robert Silverberg
The New Atlantis	Ursula K. Le Guin
The New York Review of Bird	Harlan Ellison
The Next in Line	Ray Bradbury
The Night That All Time Broke Out	Brian W. Aldiss
The Norton Book of Science Fiction	Brian Attebery
The Norton Book of Science Fiction	Ursula K. Le Guin
The October Country	Ray Bradbury
The Off Season	Ray Bradbury
The Old Man and the Sea	Ernest Hemingway
The Old Ones	Ray Bradbury
The Oldest Soldier	Fritz Leiber
The Original Hitchhiker Radio Scripts	Douglas Adams
The Original Illustrated Sherlock Holmes	Arthur Conan Doyle
The Other Death	Jorge Luis Borges
The Other Eye of Polyphemus	Harlan Ellison
The Outcast of Redwall	Brian Jacques
The Outpost Undiscovered by Tourists	Harlan Ellison
The Oxford Book of English Verse	Christopher Ricks
The Pale Silver Dollar of the Moon Pays Its Way and Makes Change vr.1	Harlan Ellison
The Pale Silver Dollar of the Moon Pays Its Way and Makes Change vr.2	Harlan Ellison
The Paper Menagerie	Ken Liu
The Patterns of Drone	Theodore Sturgeon
The People Who Walked On	Tadeusz Borowski
The Perfect Match	Ken Liu
The Peripheral	William Gibson
The Phantom of the Sewers	Philip Jose Farmer
The Place with No Name	Harlan Ellison
The Plot	Jorge Luis Borges
The Plot Is the Thing	Robert Bloch
The Private War of Private Jacob	Joe Haldeman
The Problem of the Sore Bridge-Among Others	Philip Jose Farmer
The Proud Tower	Barbara W. Tuchman
The Prowler in the City on the Edge of Forever	Harlan Ellison
The Recognition	J. G. Ballard
The Red Canary	Kate Wilhelm
The Red-Headed League	Arthur Conan Doyle
The Region Between	Harlan Ellison
The Regular	Ken Liu
The Resurgence of Miss Ankle-Strap Wedgie	Harlan Ellison
The Return of the King	J. R. R. Tolkien
The Right Stuff	Tom Wolfe
The Rise of Endymion	Dan Simmons
The Road	Cormac McCarthy
The Roads Must Roll	Robert A. Heilein
The Salmon of Doubt	Douglas Adams
The Season of Babies	Miram Allen deFord
The Secret Miracle	Jorge Luis Borges
The Sect of Phoenix	Jorge Luis Borges
The Settlers	Ray Bradbury
The Sex Opposite	Theodore Sturgeon
The Shape of the Sword	Jorge Luis Borges
The Shore	Ray Bradbury
The Silent Towns	Ray Bradbury
The Silver Corridor	Harlan Ellison
The Simple Way	Clifford D. Simak
The Singers	W. Grey Walter
The Sirens of Titan	Kurt Vonnegut
The Skills of Xanadu	Theodore Sturgeon
The Sky is Burning	Harlan Ellison
The Small Assaassin	Ray Bradbury
The Smiling Future	Miram Allen deFord
The Sound and the Fury	William Faulkner
The South	Jorge Luis Borges
The Space Merchants	C. M. Kornbluth
The Space Merchants	Frederik Pohl
The Stars My Destination	Alfred Bester
The Starseekers	Frederik Pohl
The Start of the End of It All	Carol Emshwiller
The Stochastic Man	Robert Silverberg
The Summer Night	Ray Bradbury
The Sun also Rises	Ernest Hemingway
The Superior Sex	Miram Allen deFord
The Supper	Tadeusz Borowski
The Sycthe	Ray Bradbury
The Taxpayer	Ray Bradbury
The Tell-Tale Heart and Other Writings	Edgar Allan Poe
The Tempest	William Shakespeare
The Test Stand	Lee Corey
The Test-Tube Creature, Afterward	Joan Bernott
The Theologians	Jorge Luis Borges
The Third Ear	Curt Siodmak
The Third Expedition	Ray Bradbury
The Three Stigmata of Palmer Eldritch	Philip K. Dick
The Three-Body Problem	Liu Cixin
The Tides of the Mind	David Gelernter
The Time Piece	Kate Wilhelm
The Transit of Venus	Miram Allen deFord
The Transmigration of Timothy Archer	Philip K. Dick
The Tree Lord of Imeten	Tom Purdom
The Trial	Franz Kafka
The Two Kings and the Two Labyrinths	Jorge Luis Borges
The Two Towers	J. R. R. Tolkien
The Ultimate Hitchhiker's Guide	Douglas Adams
The Universe of Robert Blake	Harlan Ellison
The Unspeakable Betrothal	Robert Bloch
The Very Last Day of a Good Woman	Harlan Ellison
The View from the Stars	Walter M. Miller, Jr.
The Village	Kate Wilhelm
The Visit	Frederik Pohl
The Voice of the Sonar in My Veriform Appendix	Philip Jose Farmer
The Volcano	Philip Jose Farmer
The Wages of Humanity	Liu Cixin
The Waiting	Jorge Luis Borges
The Wall and the Books	Jorge Luis Borges
The Wandering Earth	Liu Cixin
The War at Home	Lewis Shiner
The Warlord of Saturn's Moon	Eleanor Aranason
The Watchers	Ray Bradbury
The Watchful Poker Chip of H. Matisse	Ray Bradbury
The Waves	Ken Liu
The Westing Game	Ellen Raskin
The Whimper of Whipped Dogs	Harlan Ellison
The Will	Walter M. Miller, Jr.
The Wind	Ray Bradbury
The Wind Beyond the Mountains	Harlan Ellison
The Windup Girl	Paolo Bacigalupi
The Wine Has Been Left Open Too Long and the Memory Has Gone Flat	Harlan Ellison
The Winter Flies	Fritz Leiber
The Winter Market	William Gibson
The Witness	Jorge Luis Borges
The Women Men Don't See	James Tiptree, Jr.
The Wonderful Death of Dudley Stone	Ray Bradbury
The Word for World is Forrest	Ursula K. Le Guin
The World Inside	Robert Silverberg
The World of Professor Layton	Jun Suzuki
The World of Stone	Tadeusz Borowski
The Writing of the God	Jorge Luis Borges
The Year of the Jackpot	Robert A. Heinlein
The Year of the Rat	Chen Qiufan
The Yellow Rose	Jorge Luis Borges
The Zahir	Jorge Luis Borges
The Zimmermann Telegram	Barbara W. Tuchman
Theme of the Traitor and Hero	Jorge Luis Borges
There Was an Old Woman	Ray Bradbury
There Will Come Soft Rains	Ray Bradbury
They Shall Have Stars	James Blish
Things Lost	Thomas M. Disch
This Immortal	Roger Zelazny
This Way for the Gas, Ladies and Gentlemen	Tadeusz Borowski
Thorns	Robert Silverberg
Thousand Cranes	Yasunari Kawabata
Three Versions of Judas	Jorge Luis Borges
Throwback	Miram Allen deFord
Thunder and Roses	Theodore Sturgeon
Time Travel for Pedestrians	Ray Nelson
Tiny Ally	Harlan Ellison
Tissue	James Sallis
Tlon, Uqbar, Orbis Teritus	Jorge Luis Borges
To Be Continued	Robert Silverberg
To Explain to Mrs. Thompson	Phillip Latham
To Here and the Easel	Theodore Sturgeon
To Kill a Mockingbird	Harper Lee
To Open the Sky	Robert Silverberg
Toenails	Jorge Luis Borges
Tongtong's Summer	Xia Jia
Totenbuch	A. Parra (y Figuerado)
Touched With Fire	Ray Bradbury
Tower of Babylon	Ted Chiang
Tower of Glass	Robert Silverberg
Tracking Level	Harlan Ellison
Transcending Destiny	Harlan Ellison
Treasure Island	Robert Lewis Stevenson
Trigun Omnibus	Yasuhiro Nightow
Triss	Brian Jacques
Trouble With Ants	Clifford D. Simak
Try and Change the Past	Fritz Leiber
Twink	Theodore Sturgeon
Ubik	Philip K. Dick
Unaccompanied Sonata	Orson Scott Card
Uncle Einar	Ray Bradbury
Uncle Fremmis	Theodore Sturgeon
Underground	Robert Bloch
Understand	Ted Chiang
Unlocking the Air	Ursula K. Le Guin
Usher II	Ray Bradbury
Valerie	Harlan Ellison
Valery as Symbol	Jorge Luis Borges
VALIS	Philip K. Dick
Vaster than Empires and More Slow	Ursula K. Le Guin
Venus Plus X	Theodore Sturgeon
Vietnam: An Epic Tragedy, 1945-1975	Max Hastings
Virtual Light	William Gibson
Visionary	Harlan Ellison
Walden; or, Life in the Woods	Henry David Thoreau
Wandering Island vol.1	Kenji Tsuruta
Wandering Island vol.2	Kenji Tsuruta
Wanted in Surgery	Harlan Ellison
Watchmen	Alan Moore
Water Is for Washing	Robert A. Heinlein
Watership Down	Richard Adams
Way in the Middle of the Air	Ray Bradbury
Way Station	Clifford D. Simak
We	Yevgeny Zamyatin
We See Things Differently	Bruce Sterling
Web of the City	Harlan Ellison
What Happened to Auguste Clarot?	Larry Eisenberg
What I Did on My Vaction This Summer by Little Bobby Hirschhorn, Age 27	Harlan Ellison
What's It Like Out There?	Edmond Hamilton
When Auld's Acquaintance is Forgot	Harlan Ellison
When I was a Hired Gun	Harlan Ellison
When I Was Miss Dow	Sonya Dorman
When it Changed	Joanna Russ
When the Bentfin Boomer Boys on Old New Alabama	Richard A. Lupoff
When the Change-Winds Blow	Fritz Leiber
Where Have You Been, Billy Boy, Billy Boy?	Kate Wilhelm
Where I Shall Dwell in the Next World	Harlan Ellison
Where Late the Sweet Birds Sang	Kate Wilhelm
With a Finger in My I	David Gerrold
With Her Eyes	Liu Cixin
With Virgin Oddum at the East Pole	Harlan Ellison
Working with the Little People	Harlan Ellison
Would You Do It for a Penny	Harlan Ellison
Xenogenesis	Miriam Allen deFord
Yeager	Chuck Yeager
Yeager	Leo Janos
Ylla	Ray Bradbury
You Triflin' Skunk	Walter M. Miller, Jr.
Zero Gee	Ben Bova
Zero History	William Gibson